12222222222223
45555555555556
45555555555556
45555555555556
45555555555556
45555555555556
45555555555556
78888888888889